data,region_code,denominazione_region,hospitalized_with_symptoms,intensive_care,total_hospitalized,home_insulation,new_positives,resigned_healed
2020-11-19T17:00:00,20,Sardegna,517,67,584,10808,479,5243
2020-10-11T17:00:00,6,Friuli Venezia Giulia,22,5,27,1296,97,3834
2020-06-24T17:00:00,7,Liguria,59,1,60,201,1,8124
2020-06-07T17:00:00,6,Friuli Venezia Giulia,22,4,26,125,0,2793
2020-06-06T17:00:00,15,Campania,97,7,104,634,0,3658
2020-12-06T17:00:00,18,Calabria,390,32,422,10239,340,7533
2020-06-26T17:00:00,3,Lombardia,501,47,548,11092,156,65323
2020-12-23T17:00:00,2,Valle d'Aosta,84,4,88,342,11,6284
2020-12-28T17:00:00,16,Puglia,1494,139,1633,51524,645,31533
2020-09-25T17:00:00,17,Basilicata,13,1,14,191,13,458
2020-03-02T18:00:00,12,Lazio,3,0,3,1,1,3
2021-01-21T17:00:00,14,Molise,56,8,64,981,34,6404
2020-05-16T17:00:00,15,Campania,351,16,367,1343,14,2562
2020-03-09T18:00:00,17,Basilicata,2,0,2,3,1,0
2020-11-11T17:00:00,1,Piemonte,4790,340,5130,55224,2953,42087
2020-07-18T17:00:00,12,Lazio,174,9,183,683,20,6703
2020-09-13T17:00:00,5,Veneto,95,14,109,2858,142,19700
2020-06-06T17:00:00,14,Molise,0,2,2,119,0,292
2020-04-06T17:00:00,22,P.A. Trento,354,79,433,1405,63,280
2020-05-07T17:00:00,21,P.A. Bolzano,87,11,98,453,9,1715
2020-12-18T17:00:00,20,Sardegna,547,53,600,15017,285,11434
2020-08-02T17:00:00,22,P.A. Trento,1,0,1,98,4,4475
2021-01-05T17:00:00,3,Lombardia,3344,475,3819,48498,1338,409548
2020-04-01T17:00:00,20,Sardegna,119,27,146,529,23,36
2020-06-19T17:00:00,22,P.A. Trento,2,0,2,54,1,3936
2020-09-16T17:00:00,6,Friuli Venezia Giulia,22,3,25,587,29,3249
2020-02-25T18:00:00,9,Toscana,2,0,2,0,2,0
2020-12-03T17:00:00,19,Sicilia,1465,221,1686,38094,1294,26432
2020-09-05T17:00:00,9,Toscana,69,8,77,1812,113,9260
2020-10-23T17:00:00,2,Valle d'Aosta,50,3,53,948,97,1166
2021-01-02T17:00:00,13,Abruzzo,443,37,480,10771,23,23266
2020-09-05T17:00:00,18,Calabria,20,0,20,305,19,1173
2020-10-06T17:00:00,20,Sardegna,125,19,144,2181,63,1898
2020-04-19T17:00:00,3,Lombardia,10342,922,11264,23233,855,19526
2020-09-19T17:00:00,20,Sardegna,91,18,109,1486,59,1431
2020-03-11T17:00:00,17,Basilicata,1,1,2,6,1,0
2020-10-05T17:00:00,17,Basilicata,30,2,32,371,14,498
2020-08-01T17:00:00,13,Abruzzo,13,1,14,101,5,2800
2020-11-22T17:00:00,21,P.A. Bolzano,453,38,491,11133,535,9107
2020-11-05T17:00:00,13,Abruzzo,458,36,494,7770,571,4273
2021-01-25T17:00:00,7,Liguria,622,67,689,3849,164,60078
2021-01-09T17:00:00,6,Friuli Venezia Giulia,690,62,752,12138,1015,40825
2021-02-11T17:00:00,5,Veneto,1029,135,1164,24454,708,284471
2020-11-22T17:00:00,12,Lazio,3298,339,3637,78416,2533,18609
2021-01-31T17:00:00,8,Emilia-Romagna,2112,206,2318,44550,1277,162307
2021-02-16T17:00:00,11,Marche,535,80,615,7390,277,51088
2020-11-21T17:00:00,11,Marche,544,86,630,14492,452,9775
2021-02-02T17:00:00,7,Liguria,630,64,694,3691,238,62299
2020-08-24T17:00:00,6,Friuli Venezia Giulia,11,2,13,278,2,3003
2020-06-26T17:00:00,11,Marche,10,0,10,397,2,5385
2020-06-25T17:00:00,22,P.A. Trento,1,0,1,51,3,4398
2020-11-30T17:00:00,15,Campania,2141,182,2323,102204,1626,49119
2020-12-12T17:00:00,22,P.A. Trento,403,44,447,1989,222,14997
2020-04-18T17:00:00,1,Piemonte,3271,323,3594,10629,661,3989
2020-07-09T17:00:00,11,Marche,5,0,5,168,4,5638
2020-06-04T17:00:00,8,Emilia-Romagna,320,49,369,2319,18,21018
2021-01-04T17:00:00,16,Puglia,1464,137,1601,51938,631,38209
2020-09-27T17:00:00,1,Piemonte,166,10,176,2457,132,28244
2021-01-14T17:00:00,14,Molise,57,8,65,1082,107,5974
2020-04-12T17:00:00,9,Toscana,983,238,1221,4941,277,578
2020-03-24T17:00:00,7,Liguria,803,147,950,742,192,193
2020-04-26T17:00:00,8,Emilia-Romagna,2695,245,2940,9401,241,8723
2020-12-01T17:00:00,6,Friuli Venezia Giulia,637,62,699,13769,736,16055
2020-03-13T17:00:00,17,Basilicata,1,1,2,8,2,0
2020-08-02T17:00:00,5,Veneto,27,4,31,1003,45,17102
2020-04-04T17:00:00,19,Sicilia,553,74,627,1099,73,95
2020-09-21T17:00:00,14,Molise,5,1,6,126,31,463
2020-02-24T18:00:00,13,Abruzzo,0,0,0,0,0,0
2020-08-20T17:00:00,13,Abruzzo,27,1,28,240,4,2841
2020-12-27T17:00:00,21,P.A. Bolzano,154,20,174,10406,57,17503
2020-09-14T17:00:00,10,Umbria,19,5,24,419,12,1554
2020-10-08T17:00:00,8,Emilia-Romagna,232,13,245,5179,184,26722
2020-03-15T17:00:00,1,Piemonte,726,171,897,133,238,0
2020-04-12T17:00:00,20,Sardegna,109,26,135,768,22,137
2020-03-24T17:00:00,13,Abruzzo,234,57,291,331,26,21
2021-01-27T17:00:00,5,Veneto,1700,258,1958,39387,2385,259235
2020-11-05T17:00:00,3,Lombardia,5318,522,5840,106684,8822,102502
2020-08-27T17:00:00,17,Basilicata,2,0,2,78,6,406
2020-10-04T17:00:00,15,Campania,450,41,491,6909,412,6472
2020-05-23T17:00:00,14,Molise,8,2,10,179,5,220
2020-11-27T17:00:00,2,Valle d'Aosta,129,15,144,1403,101,4495
2020-10-31T17:00:00,17,Basilicata,83,7,90,1356,117,704
2021-01-18T17:00:00,5,Veneto,2233,336,2569,66514,998,222062
2020-12-17T17:00:00,19,Sicilia,1131,179,1310,33378,872,45353
2020-07-13T17:00:00,10,Umbria,4,0,4,4,0,1362
2021-02-25T17:00:00,9,Toscana,853,159,1012,15118,1374,132044
2020-02-29T17:00:00,1,Piemonte,7,0,7,4,0,0
2020-04-04T17:00:00,3,Lombardia,12002,1326,13328,13892,1598,13242
2021-02-07T17:00:00,10,Umbria,411,73,484,6300,382,30866
2020-03-23T17:00:00,19,Sicilia,250,60,310,371,91,27
2020-06-24T17:00:00,11,Marche,12,0,12,459,4,5314
2020-10-28T17:00:00,11,Marche,250,32,282,4244,351,6875
2021-01-04T17:00:00,15,Campania,1377,96,1473,76024,747,112726
2021-02-06T17:00:00,7,Liguria,609,61,670,3924,276,63346
2020-08-26T17:00:00,10,Umbria,11,1,12,200,20,1407
2020-10-27T17:00:00,5,Veneto,664,83,747,18770,1526,25131
2020-07-17T17:00:00,14,Molise,1,0,1,7,0,415
2020-07-14T17:00:00,7,Liguria,23,0,23,171,6,8283
2021-02-22T17:00:00,12,Lazio,1861,233,2094,33116,854,185715
2020-12-15T17:00:00,8,Emilia-Romagna,2797,214,3011,61623,1238,76205
2020-05-24T17:00:00,16,Puglia,204,17,221,1572,10,2178
2020-05-12T17:00:00,20,Sardegna,77,11,88,418,1,718
2020-04-06T17:00:00,17,Basilicata,46,18,64,198,9,12
2020-09-01T17:00:00,6,Friuli Venezia Giulia,12,2,14,363,17,3061
2020-10-10T17:00:00,1,Piemonte,354,22,376,4365,499,29179
2020-10-20T17:00:00,19,Sicilia,542,77,619,6878,574,5353
2021-02-25T17:00:00,21,P.A. Bolzano,225,34,259,6670,355,44913
2020-08-03T17:00:00,9,Toscana,16,1,17,381,10,8974
2020-05-14T17:00:00,2,Valle d'Aosta,38,0,38,42,3,945
2020-12-02T17:00:00,9,Toscana,1514,271,1785,35740,776,64632
2020-07-25T17:00:00,21,P.A. Bolzano,6,0,6,81,6,2314
2020-07-18T17:00:00,6,Friuli Venezia Giulia,7,0,7,92,4,2906
2020-03-22T17:00:00,21,P.A. Bolzano,146,32,178,470,57,7
2020-04-12T17:00:00,3,Lombardia,11969,1176,13145,18120,1460,17166
2020-08-22T17:00:00,3,Lombardia,148,14,162,5414,185,75649
2021-01-30T17:00:00,1,Piemonte,2127,150,2277,10105,727,201344
2020-04-30T17:00:00,12,Lazio,1417,115,1532,2936,71,1707
2021-02-09T17:00:00,14,Molise,69,10,79,1275,21,7323
2020-06-09T17:00:00,19,Sicilia,39,6,45,808,2,2323
2020-09-16T17:00:00,17,Basilicata,6,1,7,157,5,431
2020-07-24T17:00:00,14,Molise,0,0,0,18,1,419
2021-02-01T17:00:00,10,Umbria,363,58,421,5222,143,29762
2020-04-21T17:00:00,2,Valle d'Aosta,99,8,107,415,5,445
2020-08-02T17:00:00,11,Marche,11,0,11,136,8,5763
2020-12-19T17:00:00,6,Friuli Venezia Giulia,594,55,649,12831,974,29645
2020-11-03T17:00:00,14,Molise,24,6,30,1214,93,705
2020-09-05T17:00:00,7,Liguria,54,7,61,646,95,8901
2020-10-06T17:00:00,7,Liguria,178,23,201,1724,170,10609
2020-04-09T17:00:00,2,Valle d'Aosta,118,18,136,473,18,154
2020-11-23T17:00:00,9,Toscana,1832,296,2128,50291,1323,41345
2020-08-30T17:00:00,21,P.A. Bolzano,8,2,10,180,8,2450
2020-10-14T17:00:00,16,Puglia,311,23,334,3895,315,5317
2020-07-03T17:00:00,13,Abruzzo,27,0,27,129,6,2678
2020-09-22T17:00:00,13,Abruzzo,54,5,59,683,18,3010
2020-09-12T17:00:00,14,Molise,3,0,3,87,3,449
2020-03-13T17:00:00,2,Valle d'Aosta,6,0,6,21,1,0
2020-03-08T18:00:00,20,Sardegna,5,0,5,6,6,0
2020-06-12T17:00:00,21,P.A. Bolzano,8,2,10,91,2,2216
2020-07-06T17:00:00,16,Puglia,18,0,18,75,0,3898
2021-01-03T17:00:00,12,Lazio,2824,309,3133,74020,1681,86927
2020-05-19T17:00:00,3,Lombardia,4426,244,4670,22621,462,42593
2020-03-13T17:00:00,18,Calabria,18,3,21,16,5,1
2020-08-06T17:00:00,15,Campania,20,1,21,364,5,4212
2020-05-11T17:00:00,3,Lombardia,5397,341,5738,24673,364,36406
2020-08-05T17:00:00,5,Veneto,33,6,39,1028,41,17150
2020-02-29T17:00:00,18,Calabria,0,0,0,1,0,0
2020-06-26T17:00:00,16,Puglia,27,0,27,126,1,3835
2020-07-04T17:00:00,1,Piemonte,225,9,234,983,11,26086
2021-02-15T17:00:00,8,Emilia-Romagna,1972,172,2144,35426,1391,189406
2020-04-29T17:00:00,18,Calabria,107,6,113,640,5,263
2020-07-13T17:00:00,7,Liguria,24,0,24,194,1,8255
2020-04-18T17:00:00,2,Valle d'Aosta,107,10,117,432,80,400
2021-01-12T17:00:00,22,P.A. Trento,343,43,386,1587,234,20941
2020-11-07T17:00:00,22,P.A. Trento,243,18,261,2357,251,7622
2020-05-20T17:00:00,5,Veneto,255,16,271,3261,33,13666
2021-02-28T17:00:00,19,Sicilia,725,133,858,25124,453,122438
2020-08-23T17:00:00,22,P.A. Trento,3,1,4,39,3,4580
2020-10-13T17:00:00,2,Valle d'Aosta,11,3,14,244,33,1125
2020-07-06T17:00:00,1,Piemonte,210,9,219,989,6,26117
2020-08-21T17:00:00,2,Valle d'Aosta,1,0,1,10,0,1064
2020-09-10T17:00:00,5,Veneto,83,12,95,2831,147,19295
2020-02-28T18:00:00,22,P.A. Trento,0,0,0,0,0,0
2020-03-15T17:00:00,6,Friuli Venezia Giulia,98,12,110,206,46,17
2020-11-03T17:00:00,3,Lombardia,4740,475,5215,93351,6804,100115
2020-06-04T17:00:00,14,Molise,0,2,2,123,0,288
2020-07-22T17:00:00,17,Basilicata,2,0,2,41,36,373
2020-11-27T17:00:00,19,Sicilia,1539,250,1789,37294,1566,19834
2020-07-29T17:00:00,22,P.A. Trento,0,0,0,98,4,4467
2020-06-18T17:00:00,14,Molise,1,0,1,59,0,357
2020-12-10T17:00:00,13,Abruzzo,657,65,722,15269,227,14197
2020-05-23T17:00:00,13,Abruzzo,156,4,160,1008,1,1659
2021-01-30T17:00:00,18,Calabria,272,18,290,8605,225,23071
2020-05-05T17:00:00,3,Lombardia,6201,509,6710,30382,500,27124
2020-11-17T17:00:00,21,P.A. Bolzano,482,44,526,10175,258,6989
2021-02-27T17:00:00,8,Emilia-Romagna,2178,214,2392,38279,2542,206815
2020-12-15T17:00:00,9,Toscana,1156,214,1370,14894,332,93619
2020-08-29T17:00:00,6,Friuli Venezia Giulia,15,0,15,333,20,3052
2020-06-23T17:00:00,21,P.A. Bolzano,3,1,4,85,0,2252
2020-12-27T17:00:00,17,Basilicata,98,5,103,5856,9,4280
2020-08-29T17:00:00,9,Toscana,44,5,49,1372,92,9125
2020-10-26T17:00:00,6,Friuli Venezia Giulia,119,27,146,3139,334,4833
2020-05-01T17:00:00,17,Basilicata,49,4,53,140,11,160
2020-06-21T17:00:00,15,Campania,41,1,42,84,2,4060
2020-04-16T17:00:00,20,Sardegna,109,24,133,732,3,214
2020-11-23T17:00:00,19,Sicilia,1604,243,1847,36066,1249,15238
2021-01-27T17:00:00,17,Basilicata,81,2,83,6867,74,5776
2020-08-23T17:00:00,17,Basilicata,1,0,1,70,5,403
2020-09-16T17:00:00,8,Emilia-Romagna,174,19,193,3986,106,25213
2020-08-02T17:00:00,20,Sardegna,3,0,3,40,4,1237
2020-10-21T17:00:00,11,Marche,115,19,134,2243,226,6497
2020-06-17T17:00:00,17,Basilicata,0,1,1,9,0,364
2020-11-13T17:00:00,6,Friuli Venezia Giulia,366,47,413,8738,831,8114
2020-05-09T17:00:00,15,Campania,415,26,441,1524,14,2223
2021-01-05T17:00:00,15,Campania,1372,97,1469,74891,688,114518
2020-11-20T17:00:00,13,Abruzzo,661,75,736,14642,705,6430
2020-09-21T17:00:00,21,P.A. Bolzano,16,1,17,423,20,2589
2020-09-26T17:00:00,2,Valle d'Aosta,3,0,3,63,11,1087
2020-04-08T17:00:00,21,P.A. Bolzano,268,65,333,948,24,371
2020-04-21T17:00:00,13,Abruzzo,318,35,353,1714,55,329
2020-03-07T18:00:00,7,Liguria,26,6,32,10,19,5
2020-10-07T17:00:00,9,Toscana,123,28,151,4279,300,10673
2020-12-26T17:00:00,20,Sardegna,478,43,521,15879,173,12945
2020-10-04T17:00:00,12,Lazio,737,48,785,7148,244,8637
2020-10-12T17:00:00,19,Sicilia,404,42,446,4236,298,4571
2020-05-06T17:00:00,11,Marche,353,42,395,2841,29,2242
2020-02-24T18:00:00,10,Umbria,0,0,0,0,0,0
2020-06-29T17:00:00,15,Campania,20,0,20,142,1,4073
2021-02-21T17:00:00,6,Friuli Venezia Giulia,350,57,407,8867,284,61925
2021-02-20T17:00:00,18,Calabria,163,15,178,6420,218,29153
2021-01-06T17:00:00,14,Molise,57,9,66,1405,27,5123
2020-12-18T17:00:00,18,Calabria,294,21,315,8188,229,11803
2020-09-09T17:00:00,22,P.A. Trento,7,0,7,313,7,4634
2020-03-20T17:00:00,12,Lazio,537,47,584,328,185,53
2020-06-15T17:00:00,14,Molise,0,0,0,70,0,346
2020-10-19T17:00:00,12,Lazio,1130,111,1241,13950,939,9703
2020-07-23T17:00:00,20,Sardegna,7,0,7,7,2,1234
2020-06-11T17:00:00,2,Valle d'Aosta,6,0,6,0,0,1041
2020-02-29T17:00:00,14,Molise,0,0,0,0,0,0
2020-06-28T17:00:00,22,P.A. Trento,2,0,2,52,3,4404
2020-07-13T17:00:00,20,Sardegna,3,0,3,7,1,1229
2020-08-16T17:00:00,10,Umbria,10,1,11,72,3,1385
2020-10-29T17:00:00,2,Valle d'Aosta,120,7,127,1457,178,1235
2020-04-20T17:00:00,14,Molise,27,2,29,184,2,50
2020-09-22T17:00:00,20,Sardegna,96,21,117,1606,53,1490
2020-11-09T17:00:00,11,Marche,519,71,590,9861,262,7543
2021-02-17T17:00:00,13,Abruzzo,551,63,614,11593,438,35434
2020-06-16T17:00:00,11,Marche,19,0,19,582,1,5168
2020-10-03T17:00:00,5,Veneto,174,21,195,3917,276,22058
2020-12-18T17:00:00,6,Friuli Venezia Giulia,601,59,660,13091,753,28409
2020-12-31T17:00:00,5,Veneto,2698,361,3059,88014,4800,156263
2020-03-06T17:00:00,7,Liguria,12,5,17,7,4,5
2020-05-04T17:00:00,10,Umbria,56,13,69,112,0,1143
2020-05-09T17:00:00,6,Friuli Venezia Giulia,101,3,104,765,8,1947
2020-05-11T17:00:00,1,Piemonte,2021,135,2156,11182,111,12038
2020-04-25T17:00:00,14,Molise,19,1,20,178,5,73
2020-09-14T17:00:00,19,Sicilia,136,16,152,1690,65,3172
2020-12-22T17:00:00,2,Valle d'Aosta,90,5,95,361,33,6249
2020-06-10T17:00:00,14,Molise,0,2,2,118,1,296
2020-11-30T17:00:00,9,Toscana,1584,278,1862,40164,893,58774
2020-11-21T17:00:00,20,Sardegna,504,70,574,11340,511,5796
2020-12-26T17:00:00,12,Lazio,2742,297,3039,73255,1123,76983
2020-03-15T17:00:00,14,Molise,3,4,7,10,0,0
2020-06-11T17:00:00,7,Liguria,107,3,110,140,10,8100
2020-07-04T17:00:00,12,Lazio,197,11,208,646,31,6477
2020-05-01T17:00:00,12,Lazio,1372,105,1477,2969,56,1744
2020-11-03T17:00:00,13,Abruzzo,429,38,467,7180,601,3909
2020-07-08T17:00:00,3,Lombardia,211,34,245,8215,71,69466
2020-03-10T18:00:00,13,Abruzzo,17,9,26,11,8,0
2021-01-21T17:00:00,18,Calabria,297,26,323,9645,258,19571
2021-02-17T17:00:00,21,P.A. Bolzano,254,39,293,7519,450,41030
2020-04-28T17:00:00,9,Toscana,619,144,763,5133,52,2524
2020-04-17T17:00:00,13,Abruzzo,319,43,362,1580,97,255
2020-12-29T17:00:00,9,Toscana,879,157,1036,8979,271,105589
2020-10-16T17:00:00,1,Piemonte,658,43,701,7357,821,29643
2021-01-21T17:00:00,5,Veneto,1991,305,2296,51261,1003,240568
2020-03-07T18:00:00,8,Emilia-Romagna,464,64,528,409,140,25
2020-04-27T17:00:00,9,Toscana,671,154,825,5158,32,2401
2021-01-06T17:00:00,5,Veneto,2612,343,2955,88344,3638,175322
2020-03-04T17:00:00,8,Emilia-Romagna,256,26,282,234,124,6
2020-08-02T17:00:00,15,Campania,35,3,38,363,7,4180
2020-10-14T17:00:00,12,Lazio,937,85,1022,10041,543,9350
2020-07-01T17:00:00,19,Sicilia,18,3,21,105,1,2673
2020-06-16T17:00:00,20,Sardegna,13,0,13,20,2,1200
2020-12-22T17:00:00,16,Puglia,1421,167,1588,51704,876,26726
2021-01-12T17:00:00,13,Abruzzo,478,38,516,10621,152,25597
2020-11-05T17:00:00,7,Liguria,1236,76,1312,9911,1208,20239
2020-05-25T17:00:00,15,Campania,287,7,294,919,6,3137
2020-10-28T17:00:00,13,Abruzzo,306,26,332,4697,434,3630
2020-08-15T17:00:00,14,Molise,0,0,0,35,2,429
2021-01-27T17:00:00,6,Friuli Venezia Giulia,646,61,707,10685,584,51807
2020-07-29T17:00:00,2,Valle d'Aosta,1,0,1,12,2,1049
2021-01-23T17:00:00,10,Umbria,292,46,338,4691,332,28061
2021-02-05T17:00:00,3,Lombardia,3549,359,3908,44294,2504,470500
2021-02-06T17:00:00,1,Piemonte,2007,140,2147,10035,717,206479
2020-03-14T17:00:00,9,Toscana,160,87,247,367,160,10
2020-05-20T17:00:00,12,Lazio,1119,74,1193,2593,28,3100
2020-03-19T17:00:00,13,Abruzzo,181,47,228,138,122,8
2020-06-29T17:00:00,3,Lombardia,321,43,364,10459,78,66376
2020-11-09T17:00:00,13,Abruzzo,513,48,561,9311,625,4669
2021-02-04T17:00:00,3,Lombardia,3539,362,3901,42995,1746,469348
2021-02-06T17:00:00,14,Molise,66,12,78,1235,78,7178
2020-12-10T17:00:00,22,P.A. Trento,431,48,479,1967,217,14626
2020-09-26T17:00:00,21,P.A. Bolzano,26,0,26,514,29,2635
2020-03-12T17:00:00,19,Sicilia,28,5,33,78,32,2
2020-03-27T17:00:00,22,P.A. Trento,341,66,407,757,94,125
2020-08-26T17:00:00,1,Piemonte,83,6,89,1119,75,27163
2020-03-05T17:00:00,3,Lombardia,1169,244,1413,364,431,376
2020-12-03T17:00:00,6,Friuli Venezia Giulia,629,59,688,14195,772,17146
2021-01-25T17:00:00,22,P.A. Trento,215,41,256,1812,32,23047
2020-04-07T17:00:00,1,Piemonte,3553,432,3985,6719,419,1320
2020-05-21T17:00:00,20,Sardegna,64,12,76,242,1,911
2020-03-03T18:00:00,21,P.A. Bolzano,1,0,1,0,0,0
2020-07-13T17:00:00,9,Toscana,7,3,10,325,4,8869
2020-12-01T17:00:00,15,Campania,2099,179,2278,100601,1113,51832
2020-12-26T17:00:00,19,Sicilia,1014,170,1184,32106,337,53361
2020-11-17T17:00:00,1,Piemonte,5150,384,5534,68252,2606,52571
2020-11-16T17:00:00,12,Lazio,3099,278,3377,65893,2407,15731
2020-12-23T17:00:00,10,Umbria,239,40,279,3269,157,23421
2020-07-23T17:00:00,6,Friuli Venezia Giulia,7,1,8,89,3,2921
2020-04-26T17:00:00,10,Umbria,91,17,108,188,2,1008
2020-11-30T17:00:00,13,Abruzzo,714,76,790,17402,556,8939
2020-08-22T17:00:00,13,Abruzzo,32,1,33,280,24,2843
2020-02-26T18:00:00,22,P.A. Trento,0,0,0,0,0,0
2020-09-13T17:00:00,6,Friuli Venezia Giulia,23,2,25,564,45,3219
2020-10-01T17:00:00,2,Valle d'Aosta,7,0,7,62,1,1100
2020-12-19T17:00:00,10,Umbria,261,41,302,3663,219,22604
2020-10-07T17:00:00,5,Veneto,214,16,230,4524,375,22464
2020-08-07T17:00:00,15,Campania,32,2,34,338,15,4240
2020-11-17T17:00:00,5,Veneto,1980,266,2246,60825,3124,39928
2020-02-27T18:00:00,2,Valle d'Aosta,0,0,0,0,0,0
2021-01-07T17:00:00,21,P.A. Bolzano,205,25,230,11021,263,18700
2020-11-14T17:00:00,19,Sicilia,1462,215,1677,26129,1729,11444
2021-02-07T17:00:00,8,Emilia-Romagna,1950,181,2131,41130,1382,173828
2020-11-22T17:00:00,7,Liguria,1253,122,1375,14503,611,30008
2020-03-25T17:00:00,17,Basilicata,20,14,34,78,21,0
2020-06-18T17:00:00,22,P.A. Trento,2,0,2,57,8,3933
2020-09-20T17:00:00,22,P.A. Trento,13,0,13,544,45,4772
2020-04-20T17:00:00,6,Friuli Venezia Giulia,140,22,162,1028,30,1346
2020-05-13T17:00:00,16,Puglia,310,27,337,1985,11,1566
2021-02-09T17:00:00,2,Valle d'Aosta,19,3,22,133,14,7304
2020-11-10T17:00:00,3,Lombardia,6682,708,7390,128115,10955,122410
2020-07-31T17:00:00,3,Lombardia,148,7,155,5856,77,73402
2020-08-04T17:00:00,10,Umbria,7,0,7,22,2,1368
2020-07-20T17:00:00,14,Molise,1,0,1,7,0,415
2020-11-23T17:00:00,10,Umbria,371,78,449,10034,105,11054
2020-12-28T17:00:00,20,Sardegna,497,44,541,15803,156,13226
2020-04-14T17:00:00,2,Valle d'Aosta,112,14,126,433,20,270
2020-11-07T17:00:00,19,Sicilia,1161,169,1330,19407,1363,8788
2020-07-28T17:00:00,15,Campania,27,4,31,362,29,4128
2020-08-28T17:00:00,6,Friuli Venezia Giulia,13,0,13,334,19,3033
2020-11-10T17:00:00,13,Abruzzo,530,46,576,9852,746,4832
2020-10-16T17:00:00,18,Calabria,51,4,55,849,102,1581
2020-05-30T17:00:00,18,Calabria,23,1,24,127,0,910
2020-12-04T17:00:00,9,Toscana,1418,263,1681,31598,1071,70798
2020-06-19T17:00:00,3,Lombardia,1537,60,1597,12448,157,62096
2020-12-27T17:00:00,5,Veneto,2626,360,2986,87035,3337,144593
2020-07-21T17:00:00,10,Umbria,6,0,6,8,3,1365
2020-10-24T17:00:00,19,Sicilia,606,90,696,9193,886,5896
2020-12-19T17:00:00,13,Abruzzo,565,43,608,12332,156,19195
2020-11-18T17:00:00,5,Veneto,2079,274,2353,61953,2972,41613
2020-11-09T17:00:00,18,Calabria,256,16,272,5173,443,2319
2020-04-06T17:00:00,14,Molise,34,5,39,148,0,24
2020-03-19T17:00:00,8,Emilia-Romagna,1900,260,2160,2346,689,177
2021-02-06T17:00:00,2,Valle d'Aosta,24,3,27,141,8,7266
2020-05-12T17:00:00,8,Emilia-Romagna,1384,136,1520,5281,53,16243
2021-02-05T17:00:00,8,Emilia-Romagna,1990,182,2172,40964,1364,171260
2021-02-12T17:00:00,9,Toscana,685,126,811,10738,727,125937
2020-05-31T17:00:00,6,Friuli Venezia Giulia,41,1,42,236,2,2662
2020-06-03T17:00:00,7,Liguria,169,6,175,339,17,7764
2020-09-04T17:00:00,21,P.A. Bolzano,8,2,10,199,11,2472
2020-06-14T17:00:00,17,Basilicata,0,1,1,10,0,363
2020-09-25T17:00:00,22,P.A. Trento,13,0,13,535,23,4876
2021-01-13T17:00:00,20,Sardegna,532,47,579,16868,233,16357
2020-03-17T17:00:00,16,Puglia,155,14,169,151,110,2
2020-03-07T18:00:00,19,Sicilia,8,0,8,25,11,2
2021-02-17T17:00:00,19,Sicilia,961,154,1115,32540,484,109615
2020-10-06T17:00:00,10,Umbria,45,5,50,698,62,1923
2021-02-03T17:00:00,22,P.A. Trento,158,33,191,2304,261,24365
2020-09-12T17:00:00,3,Lombardia,251,27,278,8289,269,77611
2020-09-25T17:00:00,20,Sardegna,112,19,131,1653,57,1596
2020-06-16T17:00:00,3,Lombardia,1902,69,1971,13262,143,60361
2020-05-13T17:00:00,17,Basilicata,42,1,43,88,2,231
2020-05-23T17:00:00,7,Liguria,247,20,267,1467,38,6279
2020-11-21T17:00:00,22,P.A. Trento,413,40,453,2249,212,10694
2021-01-15T17:00:00,5,Veneto,2386,327,2713,72640,1079,211662
2020-09-02T17:00:00,2,Valle d'Aosta,3,0,3,29,2,1065
2020-07-28T17:00:00,3,Lombardia,151,13,164,6514,53,72528
2020-11-06T17:00:00,13,Abruzzo,468,42,510,8071,395,4340
2020-03-16T17:00:00,18,Calabria,36,7,43,44,21,1
2020-10-11T17:00:00,3,Lombardia,433,48,481,12368,1032,83190
2020-08-26T17:00:00,13,Abruzzo,34,1,35,331,26,2849
2020-03-06T17:00:00,18,Calabria,2,0,2,2,2,0
2020-04-10T17:00:00,9,Toscana,1011,256,1267,4555,175,451
2020-12-03T17:00:00,14,Molise,65,10,75,2357,53,2362
2020-04-05T17:00:00,14,Molise,33,6,39,148,18,24
2020-10-12T17:00:00,14,Molise,9,0,9,155,7,556
2020-10-03T17:00:00,18,Calabria,36,2,38,520,24,1386
2020-03-20T17:00:00,17,Basilicata,8,5,13,39,15,0
2020-10-25T17:00:00,20,Sardegna,299,34,333,4421,195,2814
2020-10-02T17:00:00,15,Campania,439,39,478,6267,392,6315
2020-11-20T17:00:00,15,Campania,2244,201,2445,96547,4226,29293
2020-05-22T17:00:00,11,Marche,101,15,116,1652,8,3939
2020-06-14T17:00:00,18,Calabria,15,1,16,28,0,1021
2020-09-21T17:00:00,3,Lombardia,283,36,319,8757,90,78849
2020-06-01T17:00:00,13,Abruzzo,113,6,119,625,1,2093
2021-02-01T17:00:00,2,Valle d'Aosta,33,3,36,193,3,7166
2020-06-22T17:00:00,14,Molise,3,0,3,40,3,378
2020-06-21T17:00:00,10,Umbria,4,1,5,10,0,1345
2020-12-13T17:00:00,16,Puglia,1547,191,1738,50408,1175,18892
2020-05-01T17:00:00,3,Lombardia,6628,563,7191,29282,737,26136
2020-08-10T17:00:00,22,P.A. Trento,7,0,7,72,1,4512
2020-08-05T17:00:00,16,Puglia,24,0,24,128,23,3973
2020-03-30T17:00:00,21,P.A. Bolzano,231,62,293,805,111,153
2020-03-14T17:00:00,19,Sicilia,42,11,53,97,26,4
2020-07-26T17:00:00,1,Piemonte,143,5,148,654,12,26678
2020-08-18T17:00:00,17,Basilicata,0,0,0,70,8,393
2020-10-20T17:00:00,15,Campania,946,91,1037,18421,1312,8732
2020-05-19T17:00:00,2,Valle d'Aosta,26,1,27,22,1,983
2020-08-08T17:00:00,6,Friuli Venezia Giulia,11,3,14,146,6,2936
2020-03-08T18:00:00,6,Friuli Venezia Giulia,7,1,8,45,15,3
2020-09-17T17:00:00,21,P.A. Bolzano,15,2,17,309,15,2565
2021-01-13T17:00:00,1,Piemonte,2605,172,2777,11983,1009,186443
2020-08-04T17:00:00,14,Molise,1,0,1,32,0,421
2020-03-13T17:00:00,14,Molise,5,3,8,9,1,0
2020-04-24T17:00:00,7,Liguria,760,87,847,2590,124,2660
2020-03-27T17:00:00,16,Puglia,530,82,612,624,152,29
2020-08-25T17:00:00,15,Campania,76,3,79,1085,138,4370
2020-05-19T17:00:00,13,Abruzzo,188,6,194,1195,4,1419
2020-08-06T17:00:00,2,Valle d'Aosta,1,0,1,12,1,1051
2020-04-29T17:00:00,21,P.A. Bolzano,119,14,133,712,9,1388
2020-07-22T17:00:00,7,Liguria,31,0,31,164,7,8364
2020-03-13T17:00:00,16,Puglia,77,2,79,42,25,3
2021-02-23T17:00:00,8,Emilia-Romagna,2043,196,2239,34486,1588,202311
2021-01-29T17:00:00,1,Piemonte,2163,150,2313,10224,944,200521
2020-10-24T17:00:00,18,Calabria,100,10,110,1739,166,1657
2020-07-21T17:00:00,6,Friuli Venezia Giulia,7,0,7,92,2,2914
2020-10-13T17:00:00,13,Abruzzo,146,15,161,1518,146,3153
2020-07-22T17:00:00,8,Emilia-Romagna,81,7,88,1237,57,23689
2020-07-06T17:00:00,18,Calabria,4,0,4,22,0,1060
2020-05-14T17:00:00,13,Abruzzo,215,6,221,1261,9,1275
2020-07-29T17:00:00,12,Lazio,198,9,207,762,34,6780
2020-11-11T17:00:00,22,P.A. Trento,307,31,338,2449,253,8367
2020-10-05T17:00:00,12,Lazio,764,48,812,7330,248,8671
2021-02-02T17:00:00,12,Lazio,2336,289,2625,58148,842,141160
2020-05-30T17:00:00,11,Marche,66,9,75,1272,4,4393
2020-12-22T17:00:00,9,Toscana,941,175,1116,10721,309,101212
2020-06-17T17:00:00,8,Emilia-Romagna,173,11,184,1161,14,22551
2020-04-21T17:00:00,6,Friuli Venezia Giulia,139,21,160,1162,17,1229
2020-09-06T17:00:00,8,Emilia-Romagna,124,14,138,3232,124,24794
2020-03-03T18:00:00,13,Abruzzo,5,0,5,1,1,0
2020-07-15T17:00:00,1,Piemonte,163,8,171,716,8,26510
2020-09-07T17:00:00,19,Sicilia,101,13,114,1265,49,3097
2021-01-14T17:00:00,8,Emilia-Romagna,2610,233,2843,53105,1515,132548
2021-02-06T17:00:00,13,Abruzzo,461,49,510,10042,509,32918
2021-02-21T17:00:00,18,Calabria,167,16,183,6184,170,29553
2020-10-28T17:00:00,19,Sicilia,787,111,898,11290,708,6386
2020-09-29T17:00:00,22,P.A. Trento,11,0,11,576,13,4962
2020-03-26T17:00:00,16,Puglia,480,76,556,539,89,22
2020-12-18T17:00:00,7,Liguria,716,70,786,6680,287,46801
2020-09-23T17:00:00,7,Liguria,149,18,167,1426,108,9582
2020-03-27T17:00:00,3,Lombardia,11137,1292,12429,11466,2409,8001
2020-06-01T17:00:00,9,Toscana,85,25,110,972,3,7977
2020-07-28T17:00:00,16,Puglia,15,0,15,67,4,3963
2021-02-21T17:00:00,12,Lazio,1859,234,2093,33346,1048,184656
2020-04-19T17:00:00,13,Abruzzo,317,40,357,1630,34,276
2020-10-08T17:00:00,22,P.A. Trento,18,0,18,672,59,5259
2020-11-25T17:00:00,13,Abruzzo,676,72,748,16284,623,7582
2020-08-21T17:00:00,14,Molise,1,0,1,55,2,430
2020-11-27T17:00:00,22,P.A. Trento,408,44,452,1857,229,12141
2020-10-26T17:00:00,17,Basilicata,66,6,72,937,8,651
2020-09-04T17:00:00,13,Abruzzo,32,1,33,438,25,2910
2020-06-24T17:00:00,6,Friuli Venezia Giulia,13,0,13,44,0,2904
2020-09-19T17:00:00,18,Calabria,27,4,31,414,25,1267
2020-06-09T17:00:00,12,Lazio,462,47,509,2061,23,4515
2021-02-13T17:00:00,20,Sardegna,333,28,361,13664,87,25040
2020-02-26T18:00:00,6,Friuli Venezia Giulia,0,0,0,0,0,0
2020-09-21T17:00:00,16,Puglia,201,11,212,1977,81,4306
2021-01-02T17:00:00,17,Basilicata,93,3,96,6046,39,4618
2020-04-23T17:00:00,6,Friuli Venezia Giulia,138,18,156,979,41,1467
2020-05-20T17:00:00,11,Marche,125,16,141,1833,2,3716
2020-05-13T17:00:00,21,P.A. Bolzano,56,7,63,350,3,1872
2020-04-28T17:00:00,14,Molise,18,1,19,176,1,81
2020-03-20T17:00:00,18,Calabria,71,16,87,114,38,2
2021-01-25T17:00:00,13,Abruzzo,426,44,470,9726,69,29341
2020-08-29T17:00:00,15,Campania,72,2,74,1697,188,4396
2020-08-13T17:00:00,2,Valle d'Aosta,3,0,3,11,0,1057
2020-11-22T17:00:00,20,Sardegna,503,70,573,11610,404,5921
2020-11-16T17:00:00,9,Toscana,1777,284,2061,51790,2433,26070
2021-01-28T17:00:00,20,Sardegna,465,43,508,15845,237,20562
2020-08-12T17:00:00,6,Friuli Venezia Giulia,7,3,10,154,9,2949
2020-03-19T17:00:00,16,Puglia,173,31,204,245,95,4
2020-12-01T17:00:00,7,Liguria,1003,105,1108,11042,339,37469
2020-11-30T17:00:00,21,P.A. Bolzano,428,37,465,10857,183,11924
2020-12-28T17:00:00,3,Lombardia,3791,512,4303,50462,573,392854
2020-04-11T17:00:00,6,Friuli Venezia Giulia,172,28,200,1182,44,826
2020-12-02T17:00:00,20,Sardegna,577,66,643,13240,445,8004
2020-08-20T17:00:00,17,Basilicata,0,0,0,73,2,393
2020-12-29T17:00:00,21,P.A. Bolzano,136,22,158,10520,91,17607
2020-11-23T17:00:00,14,Molise,57,10,67,2341,91,1497
2020-06-19T17:00:00,10,Umbria,5,2,7,10,1,1344
2020-10-07T17:00:00,22,P.A. Trento,18,0,18,631,32,5241
2020-05-22T17:00:00,19,Sicilia,103,10,113,1406,4,1634
2021-02-06T17:00:00,3,Lombardia,3540,354,3894,44415,1923,472266
2021-01-19T17:00:00,16,Puglia,1354,142,1496,53695,850,52598
2020-03-19T17:00:00,6,Friuli Venezia Giulia,134,29,163,359,137,41
2020-11-10T17:00:00,20,Sardegna,403,51,454,8506,489,3838
2020-11-15T17:00:00,21,P.A. Bolzano,479,43,522,9768,628,6614
2021-01-12T17:00:00,3,Lombardia,3641,466,4107,50308,1146,423074
2020-11-26T17:00:00,3,Lombardia,7996,934,8930,131471,5697,231042
2020-04-30T17:00:00,16,Puglia,439,42,481,2468,43,708
2020-12-19T17:00:00,7,Liguria,702,71,773,6324,271,47429
2020-04-27T17:00:00,6,Friuli Venezia Giulia,130,13,143,1115,60,1448
2020-11-17T17:00:00,13,Abruzzo,590,66,656,13352,729,5841
2021-01-22T17:00:00,19,Sicilia,1441,222,1663,45626,1355,77269
2021-01-21T17:00:00,15,Campania,1440,100,1540,69638,1215,136008
2020-04-09T17:00:00,7,Liguria,1103,154,1257,1996,114,1085
2021-02-21T17:00:00,3,Lombardia,3741,386,4127,50918,2514,496177
2020-03-18T17:00:00,22,P.A. Trento,141,22,163,273,70,12
2020-05-29T17:00:00,11,Marche,69,9,78,1274,4,4385
2020-06-03T17:00:00,13,Abruzzo,112,3,115,621,3,2102
2021-01-10T17:00:00,17,Basilicata,81,4,85,6552,108,4967
2020-12-09T17:00:00,2,Valle d'Aosta,90,13,103,753,17,5584
2020-08-18T17:00:00,6,Friuli Venezia Giulia,5,3,8,196,10,2970
2020-11-13T17:00:00,11,Marche,559,74,633,12201,740,7902
2021-01-25T17:00:00,16,Puglia,1380,169,1549,52833,401,59097
2020-04-05T17:00:00,2,Valle d'Aosta,96,23,119,457,34,115
2020-08-18T17:00:00,2,Valle d'Aosta,1,0,1,7,0,1064
2020-04-02T17:00:00,18,Calabria,163,19,182,445,22,23
2020-07-25T17:00:00,9,Toscana,13,0,13,330,10,8941
2020-04-03T17:00:00,11,Marche,982,158,1140,2491,132,42
2020-12-15T17:00:00,3,Lombardia,4996,656,5652,70238,2404,347130
2020-09-23T17:00:00,6,Friuli Venezia Giulia,16,6,22,688,57,3401
2020-08-17T17:00:00,20,Sardegna,9,0,9,101,7,1256
2020-05-06T17:00:00,12,Lazio,1351,91,1442,2991,81,2024
2020-12-28T17:00:00,19,Sicilia,1064,175,1239,32007,650,54694
2020-03-14T17:00:00,7,Liguria,213,62,275,109,118,52
2021-02-12T17:00:00,13,Abruzzo,507,53,560,10497,357,34441
2020-08-24T17:00:00,16,Puglia,81,4,85,420,45,4010
2020-08-08T17:00:00,20,Sardegna,6,0,6,48,0,1245
2020-03-28T17:00:00,18,Calabria,107,22,129,394,61,11
2020-12-13T17:00:00,6,Friuli Venezia Giulia,655,60,715,13458,573,24683
2020-12-03T17:00:00,22,P.A. Trento,404,45,449,2083,239,13200
2020-05-09T17:00:00,12,Lazio,1277,82,1359,2986,47,2235
2020-07-25T17:00:00,7,Liguria,27,0,27,173,3,8381
2020-07-27T17:00:00,11,Marche,5,0,5,107,2,5728
2020-11-06T17:00:00,12,Lazio,2511,234,2745,43939,2699,12653
2020-11-28T17:00:00,5,Veneto,2654,309,2963,75609,3498,58756
2021-01-26T17:00:00,11,Marche,545,73,618,8130,291,42752
2020-04-12T17:00:00,11,Marche,949,114,1063,2051,92,1489
2020-08-23T17:00:00,16,Puglia,68,4,72,395,33,4003
2020-10-31T17:00:00,22,P.A. Trento,121,9,130,1795,390,6775
2020-09-26T17:00:00,9,Toscana,84,24,108,3219,110,9981
2020-07-18T17:00:00,9,Toscana,12,1,13,301,2,8915
2021-02-10T17:00:00,16,Puglia,1488,167,1655,45451,1063,80617
2021-02-01T17:00:00,21,P.A. Bolzano,233,34,267,4512,316,34829
2020-05-17T17:00:00,19,Sicilia,145,13,158,1397,6,1566
2021-02-14T17:00:00,7,Liguria,591,62,653,4362,274,65285
2020-10-16T17:00:00,16,Puglia,326,26,352,4321,313,5431
2020-04-14T17:00:00,7,Liguria,967,133,1100,2366,212,1549
2020-06-17T17:00:00,22,P.A. Trento,2,0,2,56,1,3926
2020-11-09T17:00:00,12,Lazio,2761,237,2998,50276,2153,13264
2020-06-17T17:00:00,20,Sardegna,11,0,11,20,1,1203
2020-08-11T17:00:00,19,Sicilia,44,6,50,488,89,2752
2020-08-20T17:00:00,7,Liguria,21,1,22,333,31,8636
2020-06-24T17:00:00,14,Molise,2,0,2,41,0,378
2020-10-27T17:00:00,15,Campania,1210,140,1350,31491,2761,9907
2020-04-27T17:00:00,15,Campania,541,37,578,2299,18,1120
2020-10-24T17:00:00,8,Emilia-Romagna,723,89,812,12830,1180,27343
2020-05-05T17:00:00,15,Campania,408,25,433,2097,20,1619
2020-02-27T18:00:00,6,Friuli Venezia Giulia,0,0,0,0,0,0
2020-10-18T17:00:00,21,P.A. Bolzano,67,7,74,1533,171,2919
2020-06-09T17:00:00,21,P.A. Bolzano,7,2,9,86,0,2217
2020-08-28T17:00:00,17,Basilicata,1,1,2,81,4,407
2021-02-03T17:00:00,3,Lombardia,3554,359,3913,43432,1738,467193
2021-01-16T17:00:00,13,Abruzzo,443,41,484,10802,196,26427
2020-08-28T17:00:00,20,Sardegna,23,2,25,597,55,1266
2020-08-25T17:00:00,1,Piemonte,79,6,85,1057,57,27155
2021-02-24T17:00:00,2,Valle d'Aosta,9,1,10,136,14,7435
2020-06-01T17:00:00,3,Lombardia,3085,167,3252,17609,50,52026
2020-05-01T17:00:00,21,P.A. Bolzano,112,11,123,634,10,1493
2020-07-13T17:00:00,13,Abruzzo,19,0,19,124,0,2719
2020-12-14T17:00:00,18,Calabria,346,21,367,8955,166,10244
2021-02-25T17:00:00,2,Valle d'Aosta,10,1,11,131,2,7441
2020-05-12T17:00:00,17,Basilicata,47,1,48,92,1,220
2020-08-25T17:00:00,5,Veneto,46,5,51,2068,119,17964
2020-10-20T17:00:00,5,Veneto,459,51,510,9746,490,24319
2020-12-26T17:00:00,11,Marche,412,64,476,9159,206,28359
2020-12-25T17:00:00,9,Toscana,843,166,1009,10260,613,103328
2020-05-04T17:00:00,20,Sardegna,91,9,100,553,-2,545
2020-12-31T17:00:00,16,Puglia,1490,129,1619,51383,1661,35490
2020-03-06T17:00:00,2,Valle d'Aosta,0,0,0,7,5,0
2020-11-03T17:00:00,11,Marche,374,53,427,6990,431,7160
2020-10-09T17:00:00,12,Lazio,853,57,910,8276,387,8983
2020-10-13T17:00:00,12,Lazio,896,83,979,9658,579,9238
2020-04-01T17:00:00,3,Lombardia,11927,1342,13269,12496,1565,11415
2020-10-10T17:00:00,18,Calabria,41,1,42,654,68,1457
2020-12-06T17:00:00,2,Valle d'Aosta,102,8,110,877,34,5406
2020-10-15T17:00:00,17,Basilicata,36,0,36,503,37,536
2020-06-20T17:00:00,16,Puglia,32,1,33,187,5,3765
2020-07-27T17:00:00,21,P.A. Bolzano,7,0,7,87,2,2314
2020-03-31T17:00:00,20,Sardegna,113,28,141,516,40,34
2020-04-10T17:00:00,14,Molise,28,4,32,161,9,37
2020-11-06T17:00:00,20,Sardegna,392,46,438,7248,359,3477
2020-10-25T17:00:00,7,Liguria,696,41,737,5299,657,15324
2020-12-15T17:00:00,13,Abruzzo,601,59,660,13807,100,16836
2020-09-10T17:00:00,10,Umbria,16,3,19,371,24,1521
2020-07-05T17:00:00,6,Friuli Venezia Giulia,7,0,7,66,0,2908
2020-04-03T17:00:00,2,Valle d'Aosta,85,25,110,450,51,89
2021-01-27T17:00:00,2,Valle d'Aosta,43,4,47,223,17,7092
2020-07-20T17:00:00,3,Lombardia,151,21,172,6969,56,71611
2020-07-12T17:00:00,8,Emilia-Romagna,93,10,103,1077,71,23491
2020-04-16T17:00:00,18,Calabria,157,9,166,681,38,90
2020-11-17T17:00:00,20,Sardegna,512,64,576,10208,502,4972
2020-10-20T17:00:00,3,Lombardia,1268,123,1391,24913,2023,87072
2020-07-14T17:00:00,5,Veneto,29,2,31,396,19,16952
2020-11-02T17:00:00,16,Puglia,705,88,793,11776,626,6619
2020-06-03T17:00:00,22,P.A. Trento,15,2,17,205,1,3748
2020-08-16T17:00:00,15,Campania,43,1,44,489,46,4305
2020-05-19T17:00:00,15,Campania,330,17,347,1171,12,2790
2020-12-23T17:00:00,14,Molise,53,7,60,2142,27,3791
2021-01-21T17:00:00,11,Marche,555,83,638,7436,500,41629
2020-10-25T17:00:00,10,Umbria,215,29,244,4151,463,2795
2020-02-28T18:00:00,11,Marche,3,2,5,1,3,0
2020-07-20T17:00:00,7,Liguria,28,0,28,157,12,8355
2020-04-06T17:00:00,9,Toscana,1116,279,1395,3906,154,350
2020-03-22T17:00:00,14,Molise,24,7,31,21,5,7
2020-09-21T17:00:00,22,P.A. Trento,13,0,13,545,2,4773
2021-01-03T17:00:00,7,Liguria,696,71,767,5020,221,52606
2020-03-29T17:00:00,20,Sardegna,105,23,128,454,14,29
2020-05-11T17:00:00,22,P.A. Trento,84,11,95,640,2,3119
2020-07-09T17:00:00,7,Liguria,34,1,35,243,4,8174
2021-02-24T17:00:00,17,Basilicata,82,5,87,3706,166,11041
2020-10-01T17:00:00,9,Toscana,106,22,128,3340,144,10338
2020-08-03T17:00:00,17,Basilicata,2,0,2,49,0,374
2020-04-06T17:00:00,10,Umbria,159,46,205,667,14,337
2020-09-16T17:00:00,7,Liguria,136,13,149,1174,73,9225
2020-03-25T17:00:00,22,P.A. Trento,308,65,373,685,112,90
2020-06-02T17:00:00,2,Valle d'Aosta,10,0,10,3,0,1031
2020-08-12T17:00:00,5,Veneto,33,6,39,1294,60,17376
2020-05-06T17:00:00,16,Puglia,365,36,401,2502,26,855
2020-10-12T17:00:00,1,Piemonte,457,22,479,4984,454,29314
2020-08-16T17:00:00,19,Sicilia,51,5,56,656,39,2769
2020-11-01T17:00:00,18,Calabria,161,13,174,3188,245,1831
2020-09-10T17:00:00,8,Emilia-Romagna,143,17,160,3451,110,24994
2021-01-03T17:00:00,15,Campania,1362,98,1460,76365,619,111682
2020-09-25T17:00:00,13,Abruzzo,58,5,63,754,51,3023
2021-01-30T17:00:00,14,Molise,54,8,62,1053,83,6879
2020-12-21T17:00:00,8,Emilia-Romagna,2914,203,3117,58937,1594,88011
2020-03-13T17:00:00,20,Sardegna,12,0,12,31,4,0
2020-03-29T17:00:00,13,Abruzzo,329,68,397,772,160,36
2020-07-29T17:00:00,9,Toscana,15,0,15,365,17,8944
2020-12-18T17:00:00,14,Molise,57,9,66,2669,73,3016
2020-09-19T17:00:00,3,Lombardia,271,36,307,8628,243,78695
2020-03-23T17:00:00,18,Calabria,82,20,102,178,19,5
2020-09-09T17:00:00,1,Piemonte,100,9,109,1755,112,27431
2020-06-16T17:00:00,10,Umbria,8,1,9,9,1,1342
2020-05-04T17:00:00,18,Calabria,93,4,97,577,4,356
2020-05-24T17:00:00,22,P.A. Trento,27,4,31,504,9,3412
2021-02-24T17:00:00,9,Toscana,842,163,1005,14400,857,131409
2020-04-14T17:00:00,15,Campania,618,82,700,2394,99,415
2020-05-16T17:00:00,6,Friuli Venezia Giulia,79,3,82,598,8,2184
2021-02-14T17:00:00,21,P.A. Bolzano,255,40,295,8063,395,39271
2021-01-22T17:00:00,6,Friuli Venezia Giulia,669,61,730,11360,452,48858
2020-08-01T17:00:00,1,Piemonte,96,5,101,700,16,26753
2020-06-01T17:00:00,17,Basilicata,4,0,4,24,0,344
2021-02-28T17:00:00,14,Molise,95,17,112,1664,144,8564
2020-11-07T17:00:00,20,Sardegna,390,56,446,7625,425,3513
2020-11-11T17:00:00,10,Umbria,359,68,427,9907,515,5701
2021-01-29T17:00:00,10,Umbria,349,53,402,5075,335,29285
2020-05-30T17:00:00,14,Molise,3,2,5,151,0,258
2021-02-19T17:00:00,14,Molise,80,11,91,1592,114,7904
2020-07-06T17:00:00,15,Campania,42,0,42,185,27,4087
2020-03-08T18:00:00,18,Calabria,5,0,5,4,5,0
2020-04-16T17:00:00,1,Piemonte,3418,346,3764,10019,879,3231
2020-07-04T17:00:00,11,Marche,5,0,5,198,0,5599
2021-01-20T17:00:00,21,P.A. Bolzano,218,30,248,12284,441,21205
2020-11-05T17:00:00,19,Sicilia,1147,157,1304,17222,1322,8282
2020-03-13T17:00:00,21,P.A. Bolzano,20,5,25,98,21,0
2021-01-13T17:00:00,9,Toscana,738,140,878,7948,507,113398
2020-05-09T17:00:00,17,Basilicata,45,1,46,99,0,210
2021-01-27T17:00:00,22,P.A. Trento,201,35,236,1832,242,23437
2021-02-26T17:00:00,2,Valle d'Aosta,8,1,9,132,13,7455
2020-09-18T17:00:00,15,Campania,318,20,338,4127,208,5020
2020-08-27T17:00:00,9,Toscana,43,5,48,1225,99,9100
2020-11-03T17:00:00,20,Sardegna,337,45,382,6526,302,3309
2020-08-27T17:00:00,11,Marche,8,0,8,275,61,5924
2020-02-27T18:00:00,8,Emilia-Romagna,36,6,42,54,50,0
2020-02-26T18:00:00,20,Sardegna,0,0,0,0,0,0
2020-03-05T17:00:00,16,Puglia,5,1,6,6,5,1
2020-08-19T17:00:00,12,Lazio,229,6,235,1194,75,6996
2020-07-21T17:00:00,15,Campania,33,1,34,263,6,4108
2020-04-19T17:00:00,20,Sardegna,117,22,139,725,17,265
2020-10-28T17:00:00,5,Veneto,708,90,798,20802,2143,25180
2020-12-15T17:00:00,22,P.A. Trento,412,53,465,2242,377,15344
2020-03-11T17:00:00,5,Veneto,262,68,330,610,167,54
2020-05-27T17:00:00,7,Liguria,205,14,219,1050,39,6882
2021-01-02T17:00:00,15,Campania,1355,99,1454,76561,392,110891
2020-05-25T17:00:00,22,P.A. Trento,27,4,31,486,1,3430
2021-02-18T17:00:00,20,Sardegna,295,25,320,13182,100,25940
2020-07-11T17:00:00,21,P.A. Bolzano,6,0,6,76,3,2287
2020-12-17T17:00:00,16,Puglia,1474,179,1653,50963,1073,22396
2020-07-01T17:00:00,3,Lombardia,277,41,318,9620,109,67422
2021-02-02T17:00:00,6,Friuli Venezia Giulia,579,61,640,10586,258,54251
2020-03-04T17:00:00,1,Piemonte,26,13,39,43,26,0
2021-02-01T17:00:00,8,Emilia-Romagna,2181,207,2388,44219,1051,163585
2020-07-07T17:00:00,6,Friuli Venezia Giulia,7,0,7,65,1,2910
2020-08-22T17:00:00,20,Sardegna,14,0,14,243,44,1262
2020-05-18T17:00:00,17,Basilicata,29,1,30,63,0,272
2020-07-02T17:00:00,11,Marche,8,0,8,230,3,5564
2020-12-15T17:00:00,11,Marche,467,78,545,11345,228,21882
2020-12-19T17:00:00,16,Puglia,1432,177,1609,51780,1382,24263
2021-02-27T17:00:00,1,Piemonte,1956,166,2122,13521,1188,221224
2020-06-08T17:00:00,12,Lazio,466,49,515,2100,16,4450
2020-07-29T17:00:00,3,Lombardia,154,13,167,6396,46,72689
2020-11-25T17:00:00,1,Piemonte,5095,403,5498,72423,2878,72529
2020-11-19T17:00:00,16,Puglia,1324,200,1524,26976,1263,9734
2020-12-18T17:00:00,3,Lombardia,4656,602,5258,62952,2744,363044
2020-05-12T17:00:00,21,P.A. Bolzano,56,7,63,374,0,1845
2020-09-06T17:00:00,7,Liguria,62,9,71,697,111,8949
2020-04-23T17:00:00,5,Veneto,1189,140,1329,8596,143,5750
2020-10-18T17:00:00,3,Lombardia,1065,110,1175,22119,2975,86397
2021-02-07T17:00:00,18,Calabria,233,26,259,7544,127,25764
2020-06-03T17:00:00,3,Lombardia,2995,131,3126,17098,237,53046
2021-02-04T17:00:00,21,P.A. Bolzano,249,35,284,5607,747,35744
2020-10-10T17:00:00,6,Friuli Venezia Giulia,23,6,29,1215,126,3817
2020-10-10T17:00:00,7,Liguria,222,26,248,2198,213,10820
2020-11-13T17:00:00,20,Sardegna,472,57,529,9164,623,4411
2021-02-20T17:00:00,20,Sardegna,277,29,306,12974,73,26266
2020-04-13T17:00:00,6,Friuli Venezia Giulia,159,30,189,1118,51,973
2021-02-04T17:00:00,8,Emilia-Romagna,2046,188,2234,41575,1192,169281
2020-11-17T17:00:00,3,Lombardia,8151,894,9045,147522,8448,157121
2021-01-19T17:00:00,3,Lombardia,3619,425,4044,49417,930,436485
2020-11-29T17:00:00,14,Molise,61,13,74,2571,114,1864
2020-10-26T17:00:00,15,Campania,1191,123,1314,29361,1981,9332
2020-12-11T17:00:00,16,Puglia,1595,187,1782,48209,1813,18460
2020-07-14T17:00:00,19,Sicilia,4,0,4,133,15,2695
2020-09-25T17:00:00,11,Marche,22,2,24,697,33,6140
2020-07-17T17:00:00,18,Calabria,6,0,6,63,5,1065
2020-04-08T17:00:00,9,Toscana,1066,260,1326,4231,206,430
2020-03-11T17:00:00,16,Puglia,38,4,42,29,18,1
2020-08-02T17:00:00,18,Calabria,5,1,6,92,1,1075
2020-09-08T17:00:00,2,Valle d'Aosta,2,0,2,37,5,1069
2020-08-27T17:00:00,2,Valle d'Aosta,0,0,0,13,1,1065
2020-05-15T17:00:00,19,Sicilia,198,11,209,1551,8,1351
2020-08-25T17:00:00,16,Puglia,88,4,92,456,49,4016
2020-12-20T17:00:00,9,Toscana,963,187,1150,11656,483,99538
2020-06-30T17:00:00,18,Calabria,4,0,4,23,1,1057
2020-11-20T17:00:00,8,Emilia-Romagna,2534,244,2778,60156,2533,32145
2020-10-08T17:00:00,1,Piemonte,311,16,327,3652,336,29043
2020-06-29T17:00:00,14,Molise,0,0,0,26,0,396
2020-05-19T17:00:00,11,Marche,144,17,161,1967,-3,3561
2020-09-17T17:00:00,12,Lazio,492,16,508,4775,181,7617
2020-05-12T17:00:00,16,Puglia,334,31,365,2056,10,1460
2020-11-18T17:00:00,9,Toscana,1805,282,2087,52023,2508,30573
2020-11-23T17:00:00,18,Calabria,435,47,482,9664,321,3832
2020-09-03T17:00:00,20,Sardegna,35,6,41,905,39,1274
2020-05-20T17:00:00,20,Sardegna,68,10,78,253,1,898
2020-04-19T17:00:00,22,P.A. Trento,278,41,319,1652,101,1201
2021-01-08T17:00:00,6,Friuli Venezia Giulia,671,64,735,11841,633,40138
2020-03-20T17:00:00,1,Piemonte,1541,280,1821,1423,529,8
2020-03-08T18:00:00,10,Umbria,2,2,4,22,2,0
2020-10-23T17:00:00,13,Abruzzo,228,16,244,3285,234,3293
2020-04-02T17:00:00,22,P.A. Trento,339,78,417,1170,133,229
2020-08-17T17:00:00,19,Sicilia,54,6,60,658,14,2776
2021-02-13T17:00:00,21,P.A. Bolzano,244,37,281,8130,611,38831
2020-10-30T17:00:00,11,Marche,262,39,301,5340,524,6965
2020-08-14T17:00:00,9,Toscana,12,3,15,589,26,9020
2021-01-12T17:00:00,5,Veneto,2596,359,2955,81770,2134,197517
2020-05-24T17:00:00,10,Umbria,15,2,17,36,0,1302
2020-05-16T17:00:00,8,Emilia-Romagna,740,112,852,5000,72,17370
2020-12-21T17:00:00,6,Friuli Venezia Giulia,607,56,663,12584,244,30744
2020-06-09T17:00:00,2,Valle d'Aosta,7,0,7,1,0,1039
2020-05-08T17:00:00,14,Molise,6,0,6,178,22,121
2020-09-25T17:00:00,21,P.A. Bolzano,20,1,21,493,52,2632
2020-04-10T17:00:00,11,Marche,925,127,1052,2264,129,1086
2020-09-19T17:00:00,2,Valle d'Aosta,6,0,6,42,0,1082
2020-09-19T17:00:00,21,P.A. Bolzano,15,2,17,388,26,2584
2020-08-19T17:00:00,11,Marche,13,1,14,193,7,5871
2020-04-24T17:00:00,20,Sardegna,95,19,114,690,3,351
2020-10-16T17:00:00,8,Emilia-Romagna,404,61,465,7568,544,27155
2020-09-22T17:00:00,22,P.A. Trento,13,0,13,535,25,4808
2020-09-08T17:00:00,3,Lombardia,248,27,275,7946,271,76976
2020-07-01T17:00:00,21,P.A. Bolzano,3,1,4,80,3,2266
2020-12-18T17:00:00,5,Veneto,2687,339,3026,94988,4211,105938
2020-10-06T17:00:00,21,P.A. Bolzano,21,0,21,609,17,2757
2020-04-19T17:00:00,21,P.A. Bolzano,162,23,185,1381,55,569
2020-05-02T17:00:00,15,Campania,470,27,497,2224,15,1376
2020-07-04T17:00:00,5,Veneto,16,1,17,371,4,16907
2020-05-20T17:00:00,8,Emilia-Romagna,626,96,722,4376,50,18258
2020-09-22T17:00:00,3,Lombardia,294,34,328,8699,182,79078
2020-06-09T17:00:00,6,Friuli Venezia Giulia,21,2,23,105,0,2816
2020-05-05T17:00:00,8,Emilia-Romagna,1917,191,2108,6573,100,13889
2020-04-10T17:00:00,13,Abruzzo,305,53,358,1277,83,181
2020-08-28T17:00:00,2,Valle d'Aosta,1,0,1,14,2,1065
2020-11-05T17:00:00,14,Molise,27,7,34,1301,107,746
2021-01-14T17:00:00,16,Puglia,1387,162,1549,53986,1524,47788
2020-05-11T17:00:00,14,Molise,11,0,11,218,13,132
2020-05-16T17:00:00,13,Abruzzo,195,7,202,1221,30,1372
2020-05-29T17:00:00,9,Toscana,111,31,142,1113,2,7802
